11111111111111111111111111111111111
10000000000000000000000000000000001
100000P0000000000000000000000000001
10000000000100C00000000000000000001
1C00000000010000000000C000000000001
1000000000111000E000000000000000001
10000000000000000000000000000000001
11111111111111111111111111111111111