111111111111111111111111
100000P00000000000000001
10000000000000C000000001
1C00001110000000000000C1
100000101000000000E00001
111111111111111111111111