11111111111111111111111111111111111
100000000000000100000000000001C0001
100000P0000000C10000000000000111001
10000000000100000000000000000000001
1C000000000100001000000000000000001
1000000000110001E100000000000000001
10000000000000000000000000000000001
11111111111111111111111111111111111