11111111111111111111
10000000000000000001
101000000000C0000001
1000000000E000100001
10000000000000100001
10010000000000000001
100000000000P0000011
100000010000000000C1
1C000000000000000101
11111111111111111111